ADR = "countries/ADR.txt"
AOM = "countries/AOM.txt"
AUH = "countries/AUH.txt"
BAD = "countries/BAD.txt"
BAV = "countries/BAV.txt"
BEL = "countries/BEL.txt"
BHM = "countries/BHM.txt"
BMN = "countries/BMN.txt"
CHI = "countries/CHI.txt"
CTB = "countries/CTB.txt"
DMK = "countries/DMK.txt"
DPK = "countries/DPK.txt"
DRV = "countries/DRV.txt"
ELO = "countries/ELO.txt"
ERV = "countries/ERV.txt"
FAH = "countries/FAH.txt"
FRA = "countries/FRA.txt"
GDM = "countries/GDM.txt"
GUX = "countries/GUX.txt"
GUZ = "countries/GUZ.txt"
HBG = "countries/HBG.txt"
HHZ = "countries/HHZ.txt"
HOK = "countries/HOK.txt"
ITA = "countries/ITA.txt"
ITB = "countries/ITB.txt"
ITC = "countries/ITC.txt"
ITD = "countries/ITD.txt"
ITE = "countries/ITE.txt"
ITF = "countries/ITF.txt"
ITG = "countries/ITG.txt"
JAP = "countries/JAP.txt"
KCD = "countries/KCD.txt"
KCJ = "countries/KCJ.txt"
KOR = "countries/KOR.txt"
KTL = "countries/KTL.txt"
LTT = "countries/LTT.txt"
MAN = "countries/MAN.txt"
MEN = "countries/MEN.txt"
MLB = "countries/MLB.txt"
MNC = "countries/MNC.txt"
NAL = "countries/NAL.txt"
NLO = "countries/NLO.txt"
NTL = "countries/NTL.txt"
NUB = "countries/NUB.txt"
OBK = "countries/OBK.txt"
OTC = "countries/OTC.txt"
QDN = "countries/QDN.txt"
QFK = "countries/QFK.txt"
RHN = "countries/RHN.txt"
ROV = "countries/ROV.txt"
RTA = "countries/RTA.txt"
RUH = "countries/RUH.txt"
SHD = "countries/SHD.txt"
SHT = "countries/SHT.txt"
SHX = "countries/SHX.txt"
SIC = "countries/SIC.txt"
SMN = "countries/SMN.txt"
SWS = "countries/SWS.txt"
TAW = "countries/TAW.txt"
TIB = "countries/TIB.txt"
VCS = "countries/VCS.txt"
WLO = "countries/WLO.txt"
WTB = "countries/WTB.txt"
WZB = "countries/WZB.txt"
WZS = "countries/WZS.txt"
XIK = "countries/XIK.txt"
XIN = "countries/XIN.txt"
YUN = "countries/YUN.txt"
ZZZ = "countries/ZZZ.txt"